5 4 3 2 1 0
4 4 3 2 1 0
3 3 3 2 1 0
2 2 2 2 1 0
1 1 1 1 1 0
0 0 0 0 0 0