4 3 3 0 0
3 3 3 0 0
3 1 3 0 0
2 1 4 0 0
1 1 1 0 1
