5 4 3 4 3
4 3 2 3 2
5 2 1 2 3
4 3 2 3 1
3 1 3 1 1
